11111
10001
11111
10001
1G001
11111