11111
14431
13451
12221
11231
11111