1111111111111
1CCCPCCCCC001
100001EC00001
1CCCCCCCCC001
1CCCCCCCCC001
1CCCC001
1CCCCCCCCC001
1CCCCCCCCC001
1111111111111