111111111111111111
1CCCPCCCCC00111111
10000111111EC00011
1CCCCCCCCC00111111
1CCCCCCCCC00111111
1CCCCCCCCC00111111
1CCCCCCCCC00111111
1CCCCCCCCC00111111
111111111111111111