1111111111111
1000P00000001
100001E000001
1000000000001
1000000000001
1000000000001
1000000000001
1000000000001
1111111111111