1111111111111
1CCCPCCCCC001
1000011C00001
1CCCCCCCCC001
1CCCCCCCCC001
1CCCCCCCCC001
1CCCCCCCCC001
1CCCCCCCCC001
1111111111111