111111111111
1P0C001000C1
10000E10C001
111111111111