1111111111111
1EEEEEEEEE001
1000P1EE00001
1EEEEEEECC001
1CCCCCCCCC001
1CCCCCCCCC001
1CCCCCCCCC001
1CCCCCCCCC001
1111111111111