1111111111111
1PPPPPPPPP001
100001EP00001
1PPPPPPPCC001
1CCCCCCCCC001
1CCCCCCCCC001
1CCCCCCCCC001
1CCCCCCCCC001
1111111111111