0000000000000
0CCCPCCCCC000
000000EC00000
0CCCCCCCCC000
0CCCCCCCCC000
0CCCCCCCCC000
0CCCCCCCCC000
0CCCCCCCCC000
0000000000000