1111111111111111
1P100C1CCC1CC011
10001000100010E1
1111111111111111