1111111
1000P01
1111011
1E01011
1001011
1000011
100X0C1
1000001
1111111