1111111111111111
1000P01XCCCCC0C1
1111011011111101
10C1000000000001
1011011111111011
10000000100XC0C1
100X000010000001
1000000E100000X1
1111111111111111