1111111111111111
1000PE1CCCCCC0C1
1111011011111111
1001010000000001
1011011111111101
1000000000000001
1000X00000X11111
10C0X00C00000001
1111111111111111