1111111111111111
1000PE1CCCCCC0C1
1111011X11111111
1001010000000001
1011011111111101
1000000000000001
1000X00000011111
10C0000C00000001
1111111111111111