1111111111111111
1000PE1CCCCCC0C1
1111011011111111
1001010000000001
1011011111111101
10000000000X0001
1000X00000000001
10000000000000X1
1111111111111111