11111
10101
10001
101P1
101E1
10111
101C1
10001
11111