1111111111111111
1000PE1CCCCCC001
1110111111111001
1000000000000001
1111111111111111