1111111111111111
1000PE1CCCCCC001
1110011111111001
1000010000000001
1000010000000001
1000010000000001
1111111111111111